able: having necessary power, skill, resources, or qualifications; qualified: 
about: of; concerning; in regard to: 
account: an oral or written description of particular events or situations; narrative: 
acid: 
across: from one side to the other of: 
act: anything done, being done, or to be done; 
addition: the act or process of 
adjustment: the act of 
advertisement: a paid announcement, as of goods for sale, in newspapers or magazines, on radio or television, or on the internet.
after: behind in place or position; following behind: 
again: once more; another time; 
against: in opposition to; contrary to; adverse or hostile to: 
agreement: the act of agreeing or of coming to a mutual arrangement.
air: a mixture of nitrogen, oxygen, and minute amounts of other gases that surrounds the earth and forms its atmosphere.
all: the whole of (used in referring to quantity, extent, or duration): 
almost: very nearly; all but: 
among: in, into, or through the midst of; in association or connection with; surrounded by: 
amount: the sum total of two or more quantities or sums; aggregate.
amusement: anything that amuses or entertains; pastime
and: (used to connect grammatically coordinate words, phrases, or clauses) along or together with; as well as; in addition to; besides; also; moreover: 
angle: 
angry: feeling or showing 
animal: any member of the kingdom Animalia, comprising multicellular organisms that have a well-defined shape and usually limited growth, can move voluntarily, actively acquire food and digest it internally, and have sensory and nervous systems that allow them to respond rapidly to st
answer: a spoken or written reply or response to a question, request, letter, etc.: 
ant: any of numerous black, red, brown, or yellow social insects of the family Formicidae, of worldwide distribution especially in warm climates, having a large head with inner jaws for chewing and outer jaws for carrying and digging, and living in highly organized colonies contain
any: one, a, an, or some; one or more without specification or identification: 
apparatus: a group or combination of instruments, machinery, tools, materials, etc., having a particular function or intended for a specific use: 
apple: the usually round, red or yellow, edible fruit of a small tree, 
approval: the act of 
arch: 
argument: an oral disagreement; verbal opposition; contention; altercation: 
arm: the upper limb of the human body, especially the part extending from the shoulder to the wrist.
army: the military forces of a nation, exclusive of the navy and in some countries the air force.
art: the quality, production, expression, or realm, according to aesthetic principles, of what is beautiful, appealing, or of more than ordinary significance.
as: to the same degree, amount, or extent; 
at: (used to indicate a point or place occupied in space); in, on, or near:
attack: to set upon in a forceful, violent, hostile, or aggressive way, with or without a weapon; begin fighting with: 
attempt: to make an effort at; try; undertake; seek: 
attention: the act or faculty of attending, especially by directing the mind to an object.
attraction: the act, power, or property of 
authority: the power to determine, adjudicate, or otherwise settle issues or disputes; jurisdiction; the right to control, command, or determine.
automatic: having the capability of starting, operating, moving, etc., independently: 
awake: to wake up; rouse from sleep: 
baby: an infant or very young child.
back: the rear part of the human body, extending from the neck to the lower end of the spine.
bad: not good in any manner or degree.
bag: a container or receptacle of leather, plastic, cloth, paper, etc., capable of being closed at the mouth; 
balance: a state of equilibrium or equipoise; equal distribution of weight, amount, etc.
ball: a spherical or approximately spherical body or shape; 
band: a company of persons or, sometimes, animals or things, joined, acting, or functioning together; 
base: the bottom support of anything; that on which a thing stands or rests: 
basin: a circular container with a greater width than depth, becoming smaller toward the bottom, used chiefly to hold water or other liquid, especially for washing.
basket: a container made of twigs, rushes, thin strips of wood, or other flexible material woven together.
bath: a washing or immersion of something, especially the body, in water, steam, etc., as for cleansing or medical treatment: 
be: to exist or live: 
beautiful: having 
because: for the reason that; due to the fact that: 
bed: a piece of furniture upon which or within which a person sleeps, rests, or stays when not well.
bee: any 
before: previous to; earlier or sooner than: 
behaviour: 
belief: something 
bell: a hollow instrument of cast metal, typically cup-shaped with a flaring mouth, suspended from the vertex and rung by the strokes of a clapper, hammer, or the like.
bent: curved; 
berry: any small, usually stoneless, juicy fruit, irrespective of botanical structure, as the huckleberry, strawberry, or hackberry.
between: in the space separating (two points, objects, etc.): 
bird: any warm-blooded vertebrate of the class Aves, having a body covered with feathers, forelimbs modified into wings, scaly legs, a beak, and no teeth, and bearing young in a hard-shelled egg.
birth: an act or instance of being born: 
bit: 
bite: to cut, wound, or tear with the teeth: 
bitter: having a harsh, disagreeably acrid taste, like that of aspirin, quinine, wormwood, or aloes.
black: being a color that lacks hue and brightness and absorbs light without reflecting any of the rays composing it: 
blade: the flat cutting part of a sword, knife, etc.
blood: the fluid that circulates in the principal vascular system of human beings and other vertebrates, in humans consisting of plasma in which the red blood cells, white blood cells, and platelets are suspended.
blow: a sudden, hard stroke with a hand, fist, or weapon: 
blue: the pure color of a clear sky; the primary color between green and violet in the visible spectrum, an effect of light with a wavelength between 450 and 500 nanometers.
board: a piece of wood sawed thin, and of considerable length and breadth compared with the thickness.
boat: a vessel for transport by water, constructed to provide buoyancy by excluding water and shaped to give stability and permit propulsion.
body: the physical structure and material substance of an animal or plant, living or dead.
boiling: having reached the 
bone: 
book: a handwritten or printed work of fiction or nonfiction, usually on sheets of paper fastened or bound together within covers.
boot: a covering of leather, rubber, or the like, for the foot and all or part of the leg.
bottle: a portable container for holding liquids, characteristically having a neck and mouth and made of glass or plastic.
box: a container, case, or receptacle, usually rectangular, of wood, metal, cardboard, etc., and often with a lid or removable cover.
boy: a male child, from birth to full growth, especially one less than 18 years of age.
brain: 
brake: a device for slowing or stopping a vehicle or other moving mechanism by the absorption or transfer of the energy of momentum, usually by means of friction.
branch: a division or subdivision of the stem or axis of a tree, shrub, or other plant.
brass: any of various metal alloys consisting mainly of copper and zinc.
bread: a kind of food made of flour or meal that has been mixed with milk or water, made into a dough or batter, with or without yeast or other leavening agent, and baked.
breath: the air inhaled and exhaled in respiration.
brick: a block of clay hardened by drying in the sun or burning in a kiln, and used for building, paving, etc.: traditionally, in the United States, a rectangle 2.25 � 3.75 � 8 inches (5.7 � 9.5 � 20.3 centimeters), red, brown, or yellow in color.
bridge: a structure spanning and providing passage over a river, chasm, road, or the like.
bright: radiating or reflecting light; luminous; shining: 
broken: past participle of 
brother: a male offspring having both parents in common with another offspring; a male sibling.
brown: a dark tertiary color with a yellowish or reddish hue.
brush: an implement consisting of bristles, hair, or the like, set in or attached to a handle, used for painting, cleaning, polishing, grooming, etc.
bucket: a deep, cylindrical vessel, usually of metal, plastic, or wood, with a flat bottom and a semicircular bail, for collecting, carrying, or holding water, sand, fruit, etc.; pail.
building: a relatively permanent enclosed construction over a plot of land, having a roof and usually windows and often more than one level, used for any of a wide variety of activities, as living, entertaining, or manufacturing.
bulb: 
burn: to undergo rapid combustion or consume fuel in such a way as to give off heat, gases, and, usually, light; be on fire: 
burst: to break, break open, or fly apart with sudden violence: 
business: an occupation, profession, or trade: 
but: on the contrary; 
butter: the fatty portion of milk, separating as a soft whitish or yellowish solid when milk or cream is agitated or churned.
button: a small disk, knob, or the like for sewing or otherwise attaching to an article, as of clothing, serving as a fastening when passed through a buttonhole or loop.
by: near to or next to: 
cake: a sweet, baked, breadlike food, made with or without shortening, and usually containing flour, sugar, baking powder or soda, eggs, and liquid flavoring.
camera: a device for capturing a photographic image or recording a video, using film or digital memory.
canvas: a closely woven, heavy cloth of cotton, hemp, or linen, used for tents, sails, etc.
card: a usually rectangular piece of stiff paper, thin pasteboard, or plastic for various uses, as to write information on or printed as a means of identifying the holder: 
care: a state of mind in which one is troubled; worry, anxiety, or concern: 
carriage: a wheeled vehicle for conveying persons, as one drawn by horses and designed for comfort and elegance.
cart: a heavy two-wheeled vehicle, commonly without springs, drawn by mules, oxen, or the like, used for the conveyance of heavy goods.
cat: a small domesticated 
cause: a person or thing that acts, happens, or exists in such a way that some specific thing happens as a result; the producer of an effect: 
certain: free from doubt or reservation; confident; sure: 
chain: a series of objects connected one after the other, usually in the form of a series of metal rings passing through one another, used either for various purposes requiring a flexible tie with high tensile strength, as for hauling, supporting, or confining, or in various ornament
chalk: a soft, white, powdery limestone consisting chiefly of fossil shells of foraminifers.
chance: the absence of any cause of events that can be predicted, understood, or controlled: often personified or treated as a positive agency: 
change: to make the form, nature, content, future course, etc., of (something) different from what it is or from what it would be if left alone: 
cheap: costing very little; relatively low in price; inexpensive: 
cheese: the curd of milk separated from the whey and prepared in many ways as a food.
chemical: a substance produced by or used in a chemical process.
chest: 
chief: the head or leader of an organized body of people; the person highest in authority: 
chin: the lower extremity of the face, below the mouth.
church: a building for public Christian worship.
circle: a closed plane curve consisting of all points at a given distance from a point within it called the center. Equation: 
clean: free from dirt; unsoiled; unstained: 
clear: free from darkness, obscurity, or cloudiness; light: 
clock: an instrument for measuring and recording time, especially by mechanical means, usually with hands or changing numbers to indicate the hour and minute: not designed to be worn or carried about.
cloth: a fabric formed by weaving, felting, etc., from wool, hair, silk, flax, cotton, or other fiber, used for garments, upholstery, and many other items.
cloud: a visible collection of particles of water or ice suspended in the air, usually at an elevation above the earth&#39;s surface.
coal: a black or dark-brown combustible mineral substance consisting of carbonized vegetable matter, used as a fuel.
coat: an outer garment with sleeves, covering at least the upper part of the body: 
cold: having a relatively low temperature; having little or no warmth: 
collar: the part of a shirt, coat, dress, blouse, etc., that encompasses the neckline of the garment and is sewn permanently to it, often so as to fold or roll over.
colour: 
comb: a toothed strip of plastic, hard rubber, bone, wood, or metal, used for arranging the hair, untangling it, or holding it in place.
come: to approach or move toward a particular person or place: 
comfort: to soothe, console, or reassure; bring cheer to: 
committee: a person or group of persons elected or appointed to perform some service or function, as to investigate, report on, or act upon a particular matter.
common: belonging equally to, or shared alike by, two or more or all in question: 
company: a number of individuals assembled or associated together; group of people.
comparison: the act of comparing.
competition: the act of 
complete: having all parts or elements; lacking nothing; 
complex: composed of many interconnected parts; compound; composite: 
condition: a particular mode of being of a person or thing; existing state; situation with respect to circumstances.
connection: the act or state of 
conscious: aware of one&#39;s own existence, sensations, thoughts, surroundings, etc.
control: to exercise restraint or direction over; 
cook: to prepare (food) by the use of heat, as by boiling, baking, or roasting.
copper: a malleable, ductile, metallic element having a characteristic reddish-brown color: used in large quantities as an electrical conductor and in the manufacture of alloys, as brass and bronze. 
copy: an imitation, reproduction, or transcript of an original: 
cord: a string or thin rope made of several strands braided, twisted, or woven together.
cork: the outer bark of an oak,
cotton: a soft, white, downy substance consisting of the hairs or fibers attached to the seeds of plants belonging to the genus 
cough: to expel air from the lungs suddenly with a harsh noise, often involuntarily.
country: a state or nation: 
cover: to be or serve as a covering for; extend over; rest on the surface of: 
cow: the mature female of a bovine animal, especially of the genus Bos.
crack: to break without complete separation of parts; become fissured: 
credit: commendation or honor given for some action, quality, etc.: 
crime: an action or an instance of negligence that is deemed injurious to the public welfare or morals or to the interests of the state and that is legally prohibited.
cruel: willfully or knowingly causing pain or distress to others.
crush: to press or squeeze with a force that destroys or deforms.
cry: to utter inarticulate sounds, especially of lamentation, grief, or suffering, usually with tears.
cup: a small, open container made of china, glass, metal, etc., usually having a handle and used chiefly as a receptable from which to drink tea, soup, etc.
current: passing in time; belonging to the time actually passing: 
curtain: a hanging piece of fabric used to shut out the light from a window, adorn a room, increase privacy, etc.
curve: a continuously bending line, without angles.
cushion: a soft bag of cloth, leather, or rubber, filled with feathers, air, foam rubber, etc., on which to sit, kneel, or lie.
damage: injury or harm that reduces value or usefulness: 
danger: liability or exposure to harm or injury; risk; peril.
dark: having very little or no light: 
daughter: a female child or person in relation to her parents.
day: the interval of light between two successive nights; the time between sunrise and sunset: 
dead: no longer living; deprived of life: 
dear: beloved or loved: 
death: the act of dying; the end of life; the total and permanent cessation of all the vital functions of an organism.
debt: something that is owed or that one is bound to pay to or perform for another: 
decision: the act or process of 
deep: extending far down from the top or surface: 
degree: any of a series of steps or stages, as in a process or course of action; a point in any scale.
delicate: fine in texture, quality, construction, etc.: 
dependent: relying on someone or something else for aid, support, etc.
design: to prepare the preliminary sketch or the plans for (a work to be executed), especially to plan the form and structure of: 
desire: to wish or long for; 
destruction: the act of 
detail: an individual or minute part; an item or particular.
development: the act or process of 
different: not alike in character or quality; distinct in nature; 
digestion: the process in the alimentary canal by which food is broken up physically, as by the action of the teeth, and chemically, as by the action of enzymes, and converted into a substance suitable for absorption and assimilation into the body.
direction: the act or an instance of directing
dirty: soiled with dirt; foul; unclean
discovery: the act or process of seeing, finding, or gaining knowledge of something previously unknown, or an instance of this:
discussion: an act or instance of 
disease: a disordered or incorrectly functioning organ, part, structure, or system of the body resulting from the effect of genetic or developmental errors, infection, poisons, nutritional deficiency or imbalance, toxicity, or unfavorable environmental factors; illness; sickness; ailme
disgust: to cause loathing or nausea in.
distance: the extent or amount of space between two things, points, lines, etc.
distribution: an act or instance of distributing.
division: the act or process of dividing; state of being divided.
do: to perform (an act, duty, role, etc.): 
dog: a domesticated canid, 
door: a movable, usually solid, barrier for opening and closing an entranceway, cupboard, cabinet, or the like, commonly turning on hinges or sliding in grooves.
doubt: to be uncertain about; consider questionable or unlikely; hesitate to believe: 
down: from higher to lower; in descending direction or order; toward, into, or in a lower position: 
drain: to withdraw or draw off (a liquid) gradually; remove slowly or by degrees, as by filtration: 
drawer: a sliding, lidless, horizontal compartment, as in a piece of furniture, that may be 
dress: an outer garment for women and girls, consisting of bodice and skirt in one piece.
drink: to take water or other liquid into the mouth and swallow it; 
driving: demanding a high or unreasonable rate of work from subordinates.
drop: a small quantity of liquid that falls or is produced in a more or less spherical mass; a liquid globule:
dry: free from moisture or excess moisture; not moist; not wet: 
dust: earth or other matter in fine, dry particles.
ear: the organ of hearing and equilibrium in vertebrates, in humans consisting of an external ear that gathers sound vibrations, a middle ear in which the vibrations resonate against the tympanic membrane, and a fluid-filled internal ear that maintains balance and that conducts the
early: in or during the first part of a period of time, a course of action, a series of events, etc.: 
earth: the planet third in order from the sun, having an equatorial diameter of 7,926 miles (12,755 km) and a polar diameter of 7,900 miles (12,714 km), a mean distance from the sun of 92.9 million miles (149.6 million km), and a period of revolution of 365.26 days, and having one satellite.
east: a cardinal point of the compass, 90� to the right of north. 
edge: a line or border at which a surface terminates: 
education: the act or process of imparting or acquiring general knowledge, developing the powers of reasoning and judgment, and generally of preparing oneself or others intellectually for mature life.
effect: something that is produced by an agency or cause; 
egg: the roundish reproductive body produced by the female of certain animals, as birds and most reptiles, consisting of an ovum and its envelope of albumen, jelly, membranes, egg case, or shell, according to species.
elastic: capable of returning to its original length, shape, etc., after being stretched, deformed, compressed, or expanded: 
electric: pertaining to, derived from, produced by, or involving electricity: 
end: the last part or extremity, lengthwise, of anything that is longer than it is wide or broad: 
engine: a machine for converting thermal energy into mechanical energy or power to produce force and motion.
enough: adequate for the want or need; sufficient for the purpose or to satisfy desire: 
equal: as great as; the same as (often followed by
error: a deviation from accuracy or correctness; a mistake, as in action or speech: 
even: 
event: something that happens or is regarded as happening; an occurrence, especially one of some importance.
ever: at all times; always
every: being one of a group or series taken collectively; 
example: one of a number of things, or a part of something, taken to show the character of the whole: 
exchange: to give up (something) for something else; part with for some equivalent; change for another.
existence: the state or fact of 
expansion: the act or process of expanding.
experience: a particular instance of personally encountering or undergoing something: 
expert: a person who has special skill or knowledge in some particular field; specialist; authority: 
eye: the organ of sight, in vertebrates typically one of a pair of spherical bodies contained in an orbit of the skull and in humans appearing externally as a dense, white, curved membrane, or sclera, surrounding a circular, colored portion, or iris, that is covered by a clear, cur
face: the front part of the head, from the forehead to the chin.
fact: something that actually exists; reality; truth: 
fall: to drop or descend under the force of gravity, as to a lower place through loss or lack of support.
false: not true or correct; erroneous: 
family: a basic social unit consisting of parents and their children, considered as a group, whether dwelling together or not: 
far: at or to a great distance; a long way off; at or to a remote point: 
farm: a tract of land, usually with a house, barn, silo, etc., on which crops and often livestock are raised for livelihood.
fat: having too much flabby tissue; corpulent; obese: 
father: a male parent.
fear: a distressing emotion aroused by impending danger, evil, pain, etc., whether the threat is real or imagined; the feeling or condition of being afraid.
feather: one of the horny structures forming the principal covering of birds, consisting typically of a hard, tubular portion attached to the body and tapering into a thinner, stemlike portion bearing a series of slender, barbed processes that interlock to form a flat structure on each
feeble: physically weak, as from age or sickness; frail.
feeling: the function or the power of perceiving by touch.
female: relating to or being a woman or girl.
fertile: bearing, producing, or capable of producing vegetation, crops, etc., abundantly; prolific: 
fiction: the class of literature comprising works of imaginative narration, especially in prose form.
field: an expanse of open or cleared ground, especially a piece of land suitable or used for pasture or tillage.
fight: a battle or combat.
finger: any of the terminal members of the hand, especially one other than the thumb.
fire: a state, process, or instance of combustion in which fuel or other material is ignited and combined with oxygen, giving off light, heat, and flame.
first: being before all others with respect to time, order, rank, importance, etc., used as the ordinal number of 
fish: any of various cold-blooded, aquatic vertebrates, having gills, commonly fins, and typically an elongated body covered with scales.
fixed: fastened, attached, or placed so as to be firm and not readily movable; firmly implanted; stationary; rigid.
flag: a piece of cloth, varying in size, shape, color, and design, usually attached at one edge to a staff or cord, and used as the symbol of a nation, state, or organization, as a means of signaling, etc.; 
flame: burning gas or vapor, as from wood or coal, that is undergoing combustion; a portion of ignited gas or vapor.
flat: horizontally level: 
flight: the act, manner, or power of flying.
floor: that part of a room, hallway, or the like, that forms its lower enclosing surface and upon which one walks.
flower: the blossom of a plant.
fly: Also called 
fold: to bend (cloth, paper, etc.) over upon itself.
food: any nourishing substance that is eaten, drunk, or otherwise taken into the body to sustain life, provide energy, promote growth, etc.
foolish: resulting from or showing a lack of sense; 
foot: (in vertebrates) the terminal part of the leg, below the ankle joint, on which the body stands and moves.
for: with the object or purpose of: 
force: physical power or strength possessed by a living being: 
fork: an instrument having two or more prongs or tines, for holding, lifting, etc., as an implement for handling food or any of various agricultural tools.
form: external appearance of a clearly defined area, as distinguished from color or material; 
forward: toward or at a place, point, or time in advance; 
fowl: the domestic or barnyard hen or rooster; 
frame: a border or case for enclosing a picture, mirror, etc.
free: enjoying personal rights or liberty, as a person who is not in slavery: 
frequent: happening or occurring at short intervals: 
friend: a person attached to another by feelings of affection or personal regard.
from: (used to specify a starting point in spatial movement): 
front: the foremost part or surface of anything.
fruit: any product of plant growth useful to humans or animals.
full: completely filled; containing all that can be held; filled to utmost capacity: 
future: time that is to be or come hereafter.
garden: a plot of ground, usually near a house, where flowers, shrubs, vegetables, fruits, or herbs are cultivated.
general: of or relating to all persons or things belonging to a group or category: 
get: to receive or come to have possession, use, or enjoyment of: 
girl: a female child, from birth to full growth.
give: to present voluntarily and without expecting compensation; bestow: 
glass: a hard, brittle, noncrystalline, more or less transparent substance produced by fusion, usually consisting of mutually dissolved silica and silicates that also contain soda and lime, as in the ordinary variety used for windows and bottles.
glove: a covering for the hand made with a separate sheath for each finger and for the thumb.
go: to move or proceed, especially to or from something: 
goat: any of numerous agile, hollow-horned ruminants of the genus 
gold: a precious yellow metallic element, highly malleable and ductile, and not subject to oxidation or corrosion. 
good: morally excellent; virtuous; righteous; pious: 
government: the political direction and control exercised over the actions of the members, citizens, or inhabitants of communities, societies, and states; direction of the affairs of a state, community, etc.; political administration: 
grain: a small, hard seed, especially the seed of a food plant such as wheat, corn, rye, oats, rice, or millet.
grass: any plant of the family Gramineae, having jointed stems, sheathing leaves, and seedlike grains.
great: unusually or comparatively large in size or dimensions: 
green: of the color of growing foliage, between yellow and blue in the spectrum: 
grey: 
grip: the act of grasping; a seizing and holding fast; firm grasp.
group: any collection or assemblage of persons or things; cluster; aggregation: 
growth: the act or process, or a manner of 
guide: to assist (a person) to travel through, or reach a destination in, an unfamiliar area, as by accompanying or giving directions to the person: 
gun: a weapon consisting of a metal tube, with mechanical attachments, from which projectiles are shot by the force of an explosive; a piece of ordnance.
hair: any of the numerous fine, usually cylindrical, keratinous filaments growing from the skin of humans and animals; a pilus.
hammer: a tool consisting of a solid head, usually of metal, set crosswise on a handle, used for beating metals, driving nails, etc.
hand: the terminal, prehensile part of the upper limb in humans and other primates, consisting of the wrist, metacarpal area, fingers, and thumb.
hanging: the act, an instance, or the form of capital punishment carried out by suspending one by the neck from a gallows, gibbet, or the like, until dead.
happy: delighted, pleased, or glad, as over a particular thing: 
harbour: 
hard: not soft; solid and firm to the touch; unyielding to pressure and impenetrable or almost impenetrable.
harmony: agreement; accord; harmonious relations.
hat: a shaped covering for the head, usually with a crown and brim, especially for wear outdoors.
hate: to dislike intensely or passionately; feel extreme aversion for or extreme hostility toward; detest: 
have: to possess; own; hold for use; contain: 
he: the male person or animal being discussed or last mentioned; that male.
head: the upper part of the body in humans, joined to the torso by the neck and containing the brain, eyes, ears, nose, and mouth.
healthy: possessing or enjoying good 
hear: to perceive by the ear: 
hearing: the faculty or sense by which sound is perceived.
heart: 
heat: the state of a body perceived as having or generating a relatively high degree of warmth.
help: to give or provide what is necessary to accomplish a task or satisfy a need; contribute strength or means to; render assistance to; cooperate effectively with; aid; assist: 
high: having a great or considerable extent or reach upward or vertically; lofty; tall: 
history: the branch of knowledge dealing with past events.
hole: an opening through something; gap; aperture: 
hollow: having a space or cavity inside; not solid; empty: 
hook: a curved or angular piece of metal or other hard substance for catching, pulling, holding, or suspending something.
hope: the feeling that what is wanted can be had or that events will turn out for the best: 
horn: one of the bony, permanent, hollow paired growths, often curved and pointed, that project from the upper part of the head of certain hooved mammals, as cattle, sheep, goats, or antelopes.
horse: a large, solid-hoofed, herbivorous quadruped, 
hospital: an institution in which sick or injured people are given medical or surgical treatment.
hour: a period of time equal to one twenty-fourth of a mean solar or civil day and equivalent to 60 minutes: 
house: a building in which people live; residence for human beings.
how: in what way or manner; by what means?: 
humour: 
I: Also called 
ice: the solid form of water, produced by freezing; frozen water.
idea: any conception existing in the mind as a result of mental understanding, awareness, or activity.
if: in case that; granting or supposing that; on condition that: 
ill: of unsound physical or mental health; 
important: of much or great significance or consequence: 
impulse: the influence of a particular feeling, mental state, etc.: 
in: (used to indicate inclusion within space, a place, or limits): 
increase: to make greater, as in number, size, strength, or quality; augment; add to: 
industry: the aggregate of manufacturing or technically productive enterprises in a particular field, often named after its principal product: 
ink: a fluid or viscous substance used for writing or printing.
insect: any animal of the class Insecta, comprising small, air-breathing 
instrument: a mechanical tool or implement, especially one used for delicate or precision work: 
insurance: the act, system, or business of 
interest: the feeling of a person whose attention, concern, or curiosity is particularly engaged by something: 
invention: the act of 
iron: 
island: a tract of land completely surrounded by water, and not large enough to be called a continent.
jelly: a food preparation of a soft, elastic consistency due to the presence of gelatin, pectin, etc., especially fruit juice boiled down with sugar and used as a sweet spread for bread and toast, as a filling for cakes or doughnuts, etc.
jewel: a cut and polished precious stone; gem.
join: to bring in contact, connect, or bring or put together: 
journey: a traveling from one place to another, usually taking a rather long time; trip: 
judge: a public officer authorized to hear and decide cases in a court of law; a magistrate charged with the administration of justice.
jump: to spring clear of the ground or other support by a sudden muscular effort; 
keep: to hold or retain in one&#39;s possession; hold as one&#39;s own: 
kettle: a metal container in which to boil liquids, cook foods, etc.; pot.
key: a small metal instrument specially cut to fit into a lock and move its bolt.
kick: to strike with the foot or feet: 
kind: of a good or benevolent nature or disposition, as a person: 
kiss: to touch or press with the lips slightly pursed, and then often to part them and to emit a smacking sound, in an expression of affection, love, greeting, reverence, etc.: 
knee: 
knife: an instrument for cutting, consisting essentially of a thin, sharp-edged, metal blade fitted with a handle.
knot: an interlacing, twining, looping, etc., of a cord, rope, or the like, drawn tight into a knob or lump, for fastening, binding, or connecting two cords together or a cord to something else.
knowledge: acquaintance with facts, truths, or principles, as from study or investigation; general erudition: 
land: any part of the earth&#39;s surface not covered by a body of water; the part of the earth&#39;s surface occupied by continents and islands: 
language: a body of words and the systems for their use common to a people who are of the same community or nation, the same geographical area, or the same cultural tradition: 
last: occurring or coming after all others, as in time, order, or place: 
late: occurring, coming, or being after the usual or proper time: 
laugh: to express mirth, pleasure, derision, or nervousness with an audible, vocal expulsion of air from the lungs that can range from a loud burst of sound to a series of quiet chuckles and is usually accompanied by characteristic facial and bodily movements.
law: the principles and regulations established in a community by some authority and applicable to its people, whether in the form of legislation or of custom and policies recognized and enforced by judicial decision.
lead: to go before or with to show the way; conduct or escort: 
leaf: one of the expanded, usually green organs borne by the stem of a plant.
learning: the act or process of acquiring knowledge or skill: 
leather: the skin of an animal, with the hair removed, prepared for use by tanning or a similar process designed to preserve it against decay and make it pliable or supple when dry.
left: being, relating to, or located on or nearest to the side where a person�s heart normally is (opposed to 
leg: either of the two lower limbs of a biped, as a human being, or any of the paired limbs of an animal, arthropod, etc., that support and move the body.
let: to allow or permit: 
letter: a written or printed communication addressed to a person or organization and usually transmitted by mail.
level: having no part higher than another; having a flat or even surface.
library: a place set apart to contain books, periodicals, and other material for reading, viewing, listening, study, or reference, as a room, set of rooms, or building where books may be read or borrowed.
lift: to move or bring (something) upward from the ground or other support to a higher position; 
light: something that makes things visible or affords illumination: 
like: of the same form, appearance, kind, character, amount, etc.: 
limit: the final, utmost, or furthest boundary or point as to extent, amount, continuance, procedure, etc.: 
line: a mark or stroke long in proportion to its breadth, made with a pen, pencil, tool, etc., on a surface: 
linen: fabric woven from flax yarns.
lip: either of the two fleshy parts or folds forming the margins of the mouth and functioning in speech.
liquid: composed of molecules that move freely among themselves but do not tend to separate like those of gases; neither gaseous nor solid.
list: a series of names or other items written or printed together in a meaningful grouping or sequence so as to constitute a record: 
little: small in size; not big; not large; 
living: having life; being alive; not dead: 
lock: a device for securing a door, gate, lid, drawer, or the like in position when closed, consisting of a bolt or system of bolts propelled and withdrawn by a mechanism operated by a key, dial, etc.
long: having considerable linear extent in space: 
look: to turn one&#39;s eyes toward something or in some direction in order to see: 
loose: free or released from fastening or attachment: 
loss: detriment, disadvantage, or deprivation from failure to keep, have, or get: 
loud: (of sound) strongly audible; having exceptional volume or intensity: 
love: a profoundly tender, passionate affection for another person.
low: situated, placed, or occurring not far above the ground, floor, or base: 
machine: an apparatus consisting of interrelated parts with separate functions, used in the performance of some kind of work: 
make: to bring into existence by shaping or changing material, combining parts, etc.: 
male:  relating to or being a man or boy.
man: an adult male person. 
manager: a person who has control or direction of an institution, business, etc., or of a part, division, or phase of it.
map: a representation, usually on a flat surface, as of the features of an area of the earth or a portion of the heavens, showing them in their respective forms, sizes, and relationships according to some convention of representation: 
mark: a visible impression or trace on something, such as a line, cut, dent, stain, or bruise: 
market: an open place or a covered building where buyers and sellers convene for the sale of goods; a 
married: united in wedlock; wedded: 
mass: a body of coherent matter, usually of indefinite shape and often of considerable size: 
match: a slender piece of wood, cardboard, or other flammable material tipped with a chemical substance that produces fire when rubbed on a rough or chemically prepared surface.
material: the substance or substances of which a thing is made or composed: 
may: (used to express possibility): 
meal: the food served and eaten especially at one of the customary, regular occasions for taking food during the day, as breakfast, lunch, or supper.
measure: a unit or standard of 
meat: the flesh of animals as used for food.
medical: of or relating to the science or practice of 
meeting: the act of coming together: 
memory: the mental capacity or faculty of retaining and reviving facts, events, impressions, etc., or of recalling or recognizing previous experiences.
metal: any of a class of elementary substances, as gold, silver, or copper, all of which are crystalline when solid and many of which are characterized by opacity, ductility, conductivity, and a unique luster when freshly fractured.
middle: equally distant from the extremes or outer limits; central: 
military: of, for, or pertaining to the army or armed forces, often as distinguished from the navy: 
milk: this liquid as secreted by cows, goats, or certain other animals and used by humans for food or as a source of butter, cheeses, yogurt, etc.
mind: (in a human or other conscious being) the element, part, substance, or process that reasons, thinks, feels, wills, perceives, judges, etc.: 
mine: a form of the possessive case of 
minute: the sixtieth part (1/60) of an hour; sixty seconds.
mist: a cloudlike aggregation of minute globules of water suspended in the atmosphere at or near the earth&#39;s surface, reducing visibility to a lesser degree than fog.
mixed: put together or formed by 
money: any circulating medium of exchange, including coins, 
monkey: any of more than 250 species of simian primates belonging to the two distinct lines of 
month: Also called 
moon: the earth&#39;s natural satellite, orbiting the earth at a mean distance of 238,857 miles (384,393 km) and having a diameter of 2,160 miles (3,476 km).
morning: the first part or period of the day, extending from dawn, or from midnight, to noon.
mother: a female parent.
motion: the action or process of moving or of changing place or position; movement.
mountain: a natural elevation of the earth&#39;s surface rising more or less abruptly to a summit, and attaining an altitude greater than that of a hill, usually greater than 2,000 feet (610 meters).
mouth: 
move: to pass from one place or position to another.
much: great in quantity, measure, or degree: 
muscle: a tissue composed of cells or fibers, the contraction of which produces movement in the body.
music: an art of sound in time that expresses ideas and emotions in significant forms through the elements of rhythm, melody, harmony, and color.
nail: a slender, typically rod-shaped rigid piece of metal, usually in any of numerous standard lengths from a fraction of an inch to several inches and having one end pointed and the other enlarged and flattened, for hammering into or through wood, other building materials, etc., a
name: a word or a combination of words by which a person, place, or thing, a body or class, or any object of thought is designated, called, or known.
narrow: of little breadth or width; not broad or wide; not as wide as usual or expected: 
nation: a large body of people, associated with a particular territory, that is sufficiently conscious of its unity to seek or to possess a government peculiarly its own: 
natural: existing in or formed by nature (opposed to 
near: close; to a point or place not far away: 
necessary: essential, indispensable, or requisite: 
neck: the part of the body of an animal or human being that connects the head and the trunk.
need: a requirement, necessary duty, or obligation: 
needle: a small, slender, rodlike instrument, usually of polished steel, with a sharp point at one end and an eye or hole for thread at the other, for passing thread through cloth to make stitches in sewing.
nerve: one or more bundles of fibers forming part of a system that conveys impulses of sensation, motion, etc., between the brain or spinal cord and other parts of the body.
net: a bag or other contrivance of strong thread or cord worked into an open, meshed fabric, for catching fish, birds, or other animals: 
new: of recent origin, production, purchase, etc.; having but lately come or been brought into being: 
news: a report of a recent event; intelligence; information: 
night: the period of darkness between sunset and sunrise.
no: (a negative used to express dissent, denial, or refusal, as in response to a question or request)
noise: sound, especially of a loud, harsh, or confused kind: 
normal: conforming to the standard or the common type; usual; not abnormal; 
north: a cardinal point of the compass, lying in the plane of the meridian and to the left of a person facing the rising sun. 
nose: the part of the face or facial region in humans and certain animals that contains the nostrils and the organs of smell and functions as the usual passageway for air in respiration: in humans it is a prominence in the center of the face formed of bone and cartilage, serving als
not: (used to express negation, denial, refusal, or prohibition): 
note: a brief record of something written down to assist the memory or for future reference.
now: at the present time or moment: 
number: a numeral or group of numerals.
nut: a dry fruit consisting of an edible kernel or meat enclosed in a woody or leathery shell.
observation: an act or instance of noticing or perceiving.
of: (used to indicate distance or direction from, separation, deprivation, etc.): 
off: so as to be no longer supported or attached: 
offer: to present for acceptance or rejection; proffer: 
office: a room, set of rooms, or building where the business of a commercial or industrial organization or of a professional person is conducted: 
oil: any of a large class of substances typically unctuous, viscous, combustible, liquid at ordinary temperatures, and soluble in ether or alcohol but not in water: used for anointing, perfuming, lubricating, illuminating, heating, etc.
old: far advanced in the years of one&#39;s or its life: 
on: so as to be or remain supported by or suspended from: 
only: without others or anything further; 
open: not closed or barred at the time, as a doorway by a door, a window by a sash, or a gateway by a gate: 
operation: an act or instance, process, or manner of functioning or operating.
opinion: a belief or judgment that rests on grounds insufficient to produce complete certainty.
opposite: situated, placed, or lying face to face with something else or each other, or in corresponding positions with relation to an intervening line, space, or thing: 
or: (used to connect words, phrases, or clauses representing alternatives): 
orange: a globose, reddish-yellow, bitter or sweet, edible citrus fruit.
order: an authoritative direction or instruction; 
organization: the act or process of 
ornament: an accessory, article, or detail used to beautify the appearance of something to which it is added or of which it is a part: 
other: additional or further: 
out: away from, or not in, the normal or usual place, position, state, etc.: 
oven: a chamber or compartment, as in a stove, for baking, roasting, heating, drying, etc.
over: above in place or position: 
owner: a person who 
page: one side of a leaf of something printed or written, as a book, manuscript, or letter.
pain: physical suffering or distress, as due to injury, illness, etc.
paint: a substance composed of solid coloring matter suspended in a liquid medium and applied as a protective or decorative coating to various surfaces, or to canvas or other materials in producing a work of art.
paper: a substance made from wood pulp, rags, straw, or other fibrous material, usually in thin sheets, used to bear writing or printing, for wrapping things, etc.
parallel: extending in the same direction, equidistant at all points, and never converging or diverging: 
parcel: an object, article, container, or quantity of something wrapped or packed up; small package; 
part: a portion or division of a whole that is separate or distinct; piece, fragment, fraction, or section; 
past: gone by or elapsed in time: 
paste: a mixture of flour and water, often with starch or the like, used for causing paper or other material to adhere to something.
payment: something that is 
peace: the nonwarring condition of a nation, group of nations, or the world.
pen: any of various instruments for writing or drawing with ink or a similar substance.
pencil: a slender tube of wood, metal, plastic, etc., containing a core or strip of graphite, a solid coloring material, or the like, used for writing or drawing.
person: a human being, whether an adult or child: 
physical: of or relating to the body: 
picture: a visual representation of a person, object, or scene, as a painting, drawing, photograph, etc.: 
pig: a young swine of either sex, especially a domestic hog, 
pin: a small, slender, often pointed piece of wood, metal, etc., used to fasten, support, or attach things.
pipe: a hollow cylinder of metal, wood, or other material, used for the conveyance of water, gas, steam, petroleum, etc.
place: a particular portion of space, whether of definite or indefinite extent.
plane: a flat or level surface.
plant: 
plate: a shallow, usually circular dish, often of earthenware or porcelain, from which food is eaten.
play: a dramatic composition or piece; 
please: (used as a polite addition to requests, commands, etc.) if you would be so obliging; 
pleasure: the state or feeling of being 
plough: 
pocket: a shaped piece of fabric attached inside or outside a garment and forming a pouch used especially for carrying small articles.
point: a sharp or tapering end, as of a dagger.
poison: a substance with an inherent property that tends to destroy life or impair health.
polish: to make smooth and glossy, especially by rubbing or friction: 
political: of, relating to, or concerned with 
poor: having little or no money, goods, or other means of support: 
porter: a person hired to carry burdens or baggage, as at a railroad station or a hotel.
position: condition with reference to place; location; situation.
possible: that may or can be, exist, happen, be done, be used, etc.: 
pot: a container of earthenware, metal, etc., usually round and deep and having a handle or handles and often a lid, used for cooking, serving, and other purposes.
potato: Also called Irish potato, white potato. the edible tuber of a cultivated plant
powder: any solid substance reduced to a state of fine, loose particles by crushing, grinding, disintegration, etc.
power: ability to do or act; capability of doing or accomplishing something.
present: being, existing, or occurring at this time or now; 
price: the sum or amount of money or its equivalent for which anything is bought, sold, or offered for sale.
print: to produce (a text, picture, etc.) by applying inked types, plates, blocks, or the like, to paper or other material either by direct pressure or indirectly by offsetting an image onto an intermediate roller.
prison: a building for the confinement of persons held while awaiting trial, persons sentenced after conviction, etc.
private: belonging to some particular person: 
probable: likely to occur or prove true: 
process: a systematic series of actions directed to some end: 
produce: to bring into existence; give rise to; cause: 
profit: Often 
property: that which a person owns; the possession or possessions of a particular owner: 
prose: the ordinary form of spoken or written language, without metrical structure, as distinguished from poetry or verse.
protest: an expression or declaration of objection, disapproval, or dissent, often in opposition to something a person is powerless to prevent or avoid: 
public: of, relating to, or affecting a population or a community as a whole: 
pull: to draw or haul toward oneself or itself, in a particular direction, or into a particular position: 
pump: an apparatus or machine for raising, driving, exhausting, or compressing fluids or gases by means of a piston, plunger, or set of rotating vanes.
punishment: the act of 
purpose: the reason for which something exists or is done, made, used, etc.
push: to press upon or against (a thing) with force in order to move it away.
put: to move or place (anything) so as to get it into or out of a specific location or position: 
quality: an essential or distinctive characteristic, property, or attribute: 
question: a sentence in an interrogative form, addressed to someone in order to get information in reply.
quick: done, proceeding, or occurring with promptness or rapidity, as an action, process, etc.; prompt; immediate: 
quiet: making no noise or sound, especially no disturbing sound: 
quite: completely, wholly, or entirely: 
rail: a bar of wood or metal fixed horizontally for any of various purposes, as for a support, barrier, fence, or railing.
rain: water that is condensed from the aqueous vapor in the atmosphere and falls to earth in drops more than 0.02 inch (0.5 millimeters) in diameter.
range: the extent to which or the limits between which variation is possible: 
rat: any of several long-tailed rodents of the family Muridae, of the genus 
rate: the amount of a charge or payment with reference to some basis of calculation: 
ray: a narrow beam of light.
reaction: a reverse movement or tendency; an action in a reverse direction or manner.
reading: the action or practice of a person who reads.
ready: completely prepared or in fit condition for immediate action or use: 
reason: a basis or cause, as for some belief, action, fact, event, etc.: 
receipt: a written acknowledgment of having 
record: to set down in writing or the like, as for the purpose of preserving evidence.
red: any of various colors resembling the color of blood; the primary color at one extreme end of the visible spectrum, an effect of light with a wavelength between 610 and 780 nanometers.
regret: to feel sorrow or remorse for (an act, fault, disappointment, etc.): 
regular: usual; normal; customary: 
relation: an existing connection; a significant association between or among things: 
religion: a set of beliefs concerning the cause, nature, and purpose of the universe, especially when considered as the creation of a superhuman agency or agencies, usually involving devotional and ritual observances, and often containing a 
representative: a person or thing that 
request: the act of asking for something to be given or done, especially as a favor or courtesy; solicitation or petition: 
respect: a particular, detail, or point (usually preceded by 
responsible: answerable or accountable, as for something within one&#39;s power, control, or management (often followed by 
rest: the refreshing quiet or repose of sleep: 
reward: a sum of money offered for the detection or capture of a criminal, the recovery of lost or stolen property, etc.
rhythm: movement or procedure with uniform or patterned recurrence of a beat, accent, or the like.
rice: the starchy seeds or grain of an annual marsh grass, 
right: in accordance with what is good, proper, or just: 
ring: a typically circular band of metal or other durable material, especially one of gold or other precious metal, often set with gems, for wearing on the finger as an ornament, a token of betrothal or marriage, etc.
river: a natural stream of water of fairly large size flowing in a definite course or channel or series of diverging and converging channels.
road: a long, narrow stretch with a smoothed or paved surface, made for traveling by motor vehicle, carriage, etc., between two or more points; street or highway.
rod: a stick, wand, staff, or the like, of wood, metal, or other material.
roll: to move along a surface by revolving or turning over and over, as a ball or a wheel.
roof: the external upper covering of a house or other building.
room: a portion of space within a building or other structure, separated by walls or partitions from other parts: 
root: a part of the body of a plant that develops, typically, from the radicle and grows downward into the soil, anchoring the plant and absorbing nutriment and moisture.
rough: having a coarse or uneven surface, as from projections, irregularities, or breaks; not smooth: 
round: having a flat, circular surface, as a disk.
rub: to subject the surface of (a thing or person) to pressure and friction, as in cleaning, smoothing, polishing, coating, massaging, or soothing: 
rule: a principle or regulation governing conduct, action, procedure, arrangement, etc.: 
run: to go quickly by moving the legs more rapidly than at a walk and in such a manner that for an instant in each step all or both feet are off the ground.
sad: affected by unhappiness or grief; sorrowful or mournful: 
safe: secure from liability to harm, injury, danger, or risk: 
sail: an area of canvas or other fabric extended to the wind in such a way as to transmit the force of the wind to an assemblage of spars and rigging mounted firmly on a hull, raft, iceboat, etc., so as to drive it along.
salt: a crystalline compound, sodium chloride, NaCl, occurring as a mineral, a constituent of seawater, etc., and used for seasoning food, as a preservative, etc.
same: identical with what is about to be or has just been mentioned: 
sand: the more or less fine debris of rocks, consisting of small, loose grains, often of quartz.
say: to utter or pronounce; 
scale: 
school: an institution where instruction is given, especially to persons under college age: 
science: a branch of knowledge or study dealing with a body of facts or truths systematically arranged and showing the operation of general laws: 
scissors: a cutting instrument for paper, cloth, etc., consisting of two blades, each having a ring-shaped handle, that are so pivoted together that their sharp edges work one against the other
screw: a metal fastener having a tapered shank with a helical thread, and topped with a slotted head, driven into wood or the like by rotating, especially by means of a screwdriver.
sea: the salt waters that cover the greater part of the earth&#39;s surface.
seat: something designed to support a person in a sitting position, as a chair, bench, or pew; a place on or in which one sits.
second: next after the first; being the ordinal number for two.
secret: done, made, or conducted without the knowledge of others: 
secretary: a person, usually an official, who is in charge of the records, correspondence, minutes of meetings, and related affairs of an organization, company, association, etc.: 
see: to perceive with the eyes; look at.
seed: the fertilized, matured ovule of a flowering plant, containing an embryo or rudimentary plant.
seem: to appear to be, feel, do, etc.: 
selection: an act or instance of selecting or the state of being selected; choice.
self: a person or thing referred to with respect to complete individuality: 
send: to cause, permit, or enable to go: 
sense: any of the faculties, as sight, hearing, smell, taste, or touch, by which humans and animals perceive stimuli originating from outside or inside the body: 
separate: to keep apart or divide, as by an intervening barrier or space: 
serious: of, showing, or characterized by deep thought.
servant: a person employed by another, especially to perform domestic duties.
sex: 
shade: the comparative darkness caused by the interception or screening of rays of light from an object, place, or area.
shake: to move or sway with short, quick, irregular vibratory movements.
shame: the painful feeling arising from the consciousness of something dishonorable, improper, ridiculous, etc., done by oneself or another: 
sharp: having a thin cutting edge or a fine point; well-adapted for cutting or piercing: 
sheep: any of numerous ruminant mammals of the genus Ovis, of the family Bovidae, closely related to the goats, especially O. aries, bred in a number of domesticated varieties.
shelf: a thin slab of wood, metal, etc., fixed horizontally to a wall or in a frame, for supporting objects.
ship: a vessel, especially a large oceangoing one propelled by sails or engines.
shirt: a long- or short-sleeved garment for the upper part of the body, usually lightweight and having a collar and a front opening.
shock: a sudden and violent blow or impact; 
shoe: an external covering for the human foot, usually of leather and consisting of a more or less stiff or heavy sole and a lighter upper part ending a short distance above, at, or below the ankle.
short: having little length; not long.
shut: to put (a door, cover, etc.) in position to close or obstruct.
side: one of the surfaces forming the outside of or bounding a thing, or one of the lines bounding a geometric figure.
sign: a token; indication.
silk: the soft, lustrous fiber obtained as a filament from the cocoon of the silkworm.
silver: a white, ductile metallic element, used for making mirrors, coins, ornaments, table utensils, photographic chemicals, conductors, etc.
simple: easy to understand, deal with, use, etc.: 
sister: a female offspring having both parents in common with another offspring; female sibling.
size: the spatial dimensions, proportions, magnitude, or bulk of anything: 
skin: the external covering or integument of an animal body, especially when soft and flexible.
skirt: the part of a gown, dress, slip, or coat that extends downward from the waist.
sky: the region of the clouds or the upper air; the upper atmosphere of the earth: 
sleep: to take the rest afforded by a suspension of voluntary bodily functions and the natural suspension, complete or partial, of consciousness; cease being awake.
slip: to move, flow, pass, or go smoothly or easily; glide; slide: 
slope: to have or take an inclined or oblique direction or angle considered with reference to a vertical or horizontal plane; slant.
slow: moving or proceeding with little or less than usual speed or velocity: 
small: of limited size; of comparatively restricted dimensions; not big; little: 
smash: to break to pieces with violence and often with a crashing sound, as by striking, letting fall, or dashing against something; shatter: 
smell: to perceive the odor or scent of through the nose by means of the olfactory nerves; inhale the odor of: 
smile: to assume a facial expression indicating pleasure, favor, or amusement, but sometimes derision or scorn, characterized by an upturning of the corners of the mouth.
smoke: the visible vapor and gases given off by a burning or smoldering substance, especially the gray, brown, or blackish mixture of gases and suspended carbon particles resulting from the combustion of wood, peat, coal, or other organic matter.
smooth: free from projections or unevenness of surface; not rough: 
snake: any of numerous limbless, scaly, elongate reptiles of the suborder Serpentes, comprising venomous and nonvenomous species inhabiting tropical and temperate areas.
sneeze: to emit air or breath suddenly, forcibly, and audibly through the nose and mouth by involuntary, spasmodic action.
snow: precipitation in the form of ice crystals, mainly of intricately branched, hexagonal form and often agglomerated into snowflakes, formed directly from the freezing of the water vapor in the air
so: in the way or manner indicated, described, or implied: 
soap: a substance used for washing and cleansing purposes, usually made by treating a fat with an alkali, as sodium or potassium hydroxide, and consisting chiefly of the sodium or potassium salts of the acids contained in the fat.
society: an organized group of persons associated together for religious, benevolent, cultural, scientific, political, patriotic, or other purposes.
sock: a short stocking usually reaching to the calf or just above the ankle.
soft: yielding readily to touch or pressure; easily penetrated, divided, or changed in shape; not hard or stiff: 
solid: having three dimensions (length, breadth, and thickness), as a geometrical body or figure.
some: being an undetermined or unspecified one: 
son: a male child or person in relation to his parents.
song: a short metrical composition intended or adapted for 
sort: a particular kind, species, variety, class, or group, distinguished by a common character or nature: 
sound: the sensation produced by stimulation of the organs of hearing by vibrations transmitted through the air or other medium.
soup: a liquid food made by boiling or simmering meat, fish, or vegetables with various added ingredients.
south: a cardinal point of the compass lying directly opposite north. 
space: the unlimited or incalculably great three-dimensional realm or expanse in which all material objects are located and all events occur.
spade: a tool for digging, having an iron blade adapted for pressing into the ground with the foot and a long handle commonly with a grip or crosspiece at the top, and with the blade usually narrower and flatter than that of a shovel.
special: of a distinct or particular kind or character: 
sponge: any aquatic, chiefly marine animal of the phylum Porifera, having a porous structure and usually a horny, siliceous or calcareous internal skeleton or framework, occurring in large, sessile colonies.
spoon: a utensil for use in eating, stirring, measuring, ladling, etc., consisting of a small, shallow bowl with a handle.
spring: to rise, leap, move, or act suddenly and swiftly, as by a sudden dart or thrust forward or outward, or being suddenly released from a coiled or constrained position:
square: a rectangle having all four sides of equal length.
stage: a single step or degree in a process; a particular phase, period, position, etc., in a process, development, or series.
stamp: to strike or beat with a forcible, downward thrust of the foot.
star: any of the heavenly bodies, except the moon, appearing as fixed luminous points in the sky at night.
start: to begin or set out, as on a journey or activity.
statement: something 
station: a place or position in which a person or thing is normally located.
steam: water in the form of an invisible gas or vapor.
steel: any of various modified forms of iron, artificially produced, having a carbon content less than that of pig iron and more than that of wrought iron, and having qualities of hardness, elasticity, and strength varying according to composition and heat treatment: generally catego
stem: the ascending axis of a plant, whether above or below ground, which ordinarily grows in an opposite direction to the root or descending axis.
step: a movement made by lifting the foot and setting it down again in a new position, accompanied by a shifting of the weight of the body in the direction of the new position, as in walking, running, or dancing.
stick: a branch or shoot of a tree or shrub that has been cut or broken off.
sticky: having the property of adhering, as glue; adhesive.
stiff: rigid or firm; difficult or impossible to bend or flex: 
still: remaining in place or at rest; 
stitch: one complete movement of a threaded needle through a fabric or material such as to leave behind it a single loop or portion of thread, as in sewing, embroidery, or the surgical closing of wounds.
stocking: a close-fitting covering for the foot and part of the leg, usually knitted, of wool, cotton, nylon, silk, or similar material.
stomach: 
stone: the hard substance, formed of mineral matter, of which rocks consist.
stop: to cease from, leave off, or discontinue: 
store: an establishment where merchandise is sold, usually on a retail basis.
story: a narrative, either true or fictitious, in prose or verse, designed to interest, amuse, or instruct the hearer or reader; tale.
straight: without a bend, angle, or curve; not curved; 
strange: unusual, extraordinary, or curious; odd; queer: 
street: a public thoroughfare, usually paved, in a village, town, or city, including the sidewalk or sidewalks.
stretch: to draw out or extend (oneself, a body, limbs, wings, etc.) to the full length or extent
strong: having, showing, or able to exert great bodily or muscular power; physically vigorous or robust: 
structure: mode of building, construction, or organization; arrangement of parts, elements, or constituents: 
substance: that of which a thing consists; physical matter or material: 
such: of the kind, character, degree, extent, etc., of that or those indicated or implied: 
sudden: happening, coming, made, or done quickly, without warning, or unexpectedly: 
sugar: a sweet, crystalline substance, C
suggestion: the act of suggesting.
summer: the season between spring and autumn, in the Northern Hemisphere from the 
sun: (
support: to bear or hold up (a load, mass, structure, part, etc.); serve as a foundation for.
surprise: to strike or occur to with a sudden feeling of wonder or astonishment, as through unexpectedness: 
sweet: having the taste or flavor characteristic of sugar, honey, etc.
swim: to move in water by movements of the limbs, fins, tail, etc.
system: an assemblage or combination of things or parts forming a complex or unitary whole: 
table: an article of furniture consisting of a flat, slablike top supported on one or more legs or other supports: 
tail: the hindmost part of an animal, especially that forming a distinct, flexible appendage to the back end of its body.
take: to get into one&#39;s hold or possession by voluntary action: 
talk: to communicate or exchange ideas, information, etc., by speaking: 
tall: having a relatively great height; of more than average stature: 
taste: to try or test the flavor or quality of (something) by taking some into the mouth: 
tax: a sum of money demanded by a government for its support or for specific facilities or services, levied upon incomes, property, sales, etc.
teaching: the act or profession of a person who 
tendency: a natural or prevailing disposition to move, proceed, or act in some direction or toward some point, end, or result: 
test: the means by which the presence, quality, or genuineness of anything is determined; a means of trial.
than: (used, as after comparative adjectives and adverbs, to introduce the second member of an unequal comparison): 
that: (used to indicate a person, thing, idea, state, event, time, remark, etc., as pointed out or present, mentioned before, supposed to be understood, or by way of emphasis): 
the: (used, especially before a noun, with a specifying or particularizing effect, as opposed to the indefinite or generalizing force of the indefinite article 
then: at that time: 
theory: a coherent group of tested general propositions, commonly regarded as correct, that can be used as principles of explanation and prediction for a class of phenomena: 
there: in or at that place (opposed to 
thick: having relatively great extent from one surface or side to the opposite; not thin: 
thin: having relatively little extent from one surface or side to the opposite; not thick: 
thing: a material object without life or consciousness; an inanimate object.
this: (used to indicate a person, thing, idea, state, event, time, remark, etc., as present, near, just mentioned or pointed out, supposed to be understood, or by way of emphasis): 
thought: the product of mental activity; that which one thinks: 
thread: a fine cord of flax, cotton, or other fibrous material spun out to considerable length, especially when composed of two or more filaments twisted together.
throat: the passage from the mouth to the stomach or to the lungs, including the pharynx, esophagus, larynx, and trachea.
through: in at one end, side, or surface and out at the other: 
thumb: the short, thick, inner digit of the human hand, next to the forefinger.
thunder: a loud, explosive, resounding noise produced by the explosive expansion of air heated by a lightning discharge.
ticket: a slip, usually of paper or cardboard, serving as evidence that the holder has paid a fare or admission or is entitled to some service, right, or the like: 
tight: firmly or closely fixed in place; not easily moved; 
till: up to the time of; 
time: the system of those sequential relations that any event has to any other, as past, present, or future; indefinite and continuous duration regarded as that in which events succeed one another.
tin: 
tired: exhausted, as by exertion; fatigued or sleepy: 
to: (used for expressing motion or direction toward a point, person, place, or thing approached and reached, as opposed to 
toe: one of the terminal digits of the human foot.
together: into or in one gathering, company, mass, place, or body: 
tomorrow: the day following today: 
tongue: 
tooth: (in most vertebrates) one of the hard bodies or processes usually attached in a row to each jaw, serving for the prehension and mastication of food, as weapons of attack or defense, etc., and in mammals typically composed chiefly of dentin surrounding a sensitive pulp and cove
top: the highest or loftiest point or part of anything; 
touch: to put the hand, finger, etc., on or into contact with (something) to feel it: 
town: a thickly populated area, usually smaller than a city and larger than a village, having fixed boundaries and certain local powers of government.
trade: the act or process of buying, selling, or exchanging commodities, at either wholesale or retail, within a country or between countries: 
train: 
transport: to carry, move, or convey from one place to another.
tray: a flat, shallow container or receptacle made of wood, metal, etc., usually with slightly raised edges, used for carrying, holding, or displaying articles of food, glass, china, etc.
tree: a plant having a permanently woody main stem or trunk, ordinarily growing to a considerable height, and usually developing branches at some distance from the ground.
trick: a crafty or underhanded device, maneuver, stratagem, or the like, intended to deceive or cheat; artifice; ruse; wile.
trouble: to disturb the mental calm and contentment of; worry; distress; agitate.
trousers: Sometimes 
true: being in accordance with the actual state or conditions; conforming to reality or fact; not false: 
turn: to cause to move around on an axis or about a center; 
twist: to combine, as two or more strands or threads, by winding together; 
umbrella: a light, small, portable, usually circular cover for protection from rain or sun, consisting of a fabric held on a collapsible frame of thin ribs radiating from the top of a carrying stick or handle.
under: beneath and covered by: 
unit: a single thing or person.
up: to, toward, or in a more elevated position: 
use: to employ for some purpose; put into service; make use of: 
value: relative worth, merit, or importance: 
verse: (not in technical use) a stanza.
very: in a high degree; extremely; exceedingly: 
vessel: a craft for traveling on water, now usually one larger than an ordinary rowboat; a ship or boat.
view: an instance of seeing or beholding; visual inspection.
violent: acting with or characterized by uncontrolled, strong, rough force: 
voice: the sound or sounds uttered through the mouth of living creatures, especially of human beings in speaking, shouting, singing, etc.
waiting: a period of 
walk: to advance or travel on foot at a moderate speed or pace; proceed by steps; move by advancing the feet alternately so that there is always one foot on the ground in bipedal locomotion and two or more feet on the ground in quadrupedal locomotion.
wall: any of various permanent upright constructions having a length much greater than the thickness and presenting a continuous surface except where pierced by doors, windows, etc.: used for shelter, protection, or privacy, or to subdivide interior space, to support floors, roofs, 
war: a conflict carried on by force of arms, as between nations or between parties within a nation; warfare, as by land, sea, or air.
warm: having or giving out a moderate degree of heat, as perceived by the senses: 
wash: to apply water or some other liquid to (something or someone) for the purpose of cleansing; cleanse by dipping, rubbing, or scrubbing in water or some other liquid.
waste: to consume, spend, or employ uselessly or without adequate return; use to no avail or profit; squander: 
watch: to be alertly on the lookout, look attentively, or observe, as to see what comes, is done, or happens: 
water: a transparent, odorless, tasteless liquid, a compound of hydrogen and oxygen, H
wave: a disturbance on the surface of a liquid body, as the sea or a lake, in the form of a moving ridge or swell.
wax: Also called 
way: manner, mode, or fashion: 
weather: the state of the atmosphere with respect to wind, temperature, cloudiness, moisture, pressure, etc.
week: a period of seven successive days: 
weight: the amount or quantity of heaviness or mass; amount a thing weighs.
well: in a good or satisfactory manner: 
west: a cardinal point of the compass, 90� to the left when facing north, corresponding to the point where the sun is seen to set. 
wet: moistened, covered, or soaked with water or some other liquid: 
wheel: a circular frame or disk arranged to revolve on an axis, as on or in vehicles or machinery.
when: at what time or period? how long ago? how soon?: 
where: in or at what place?: 
while: a period or interval of time: 
whip: to beat with a strap, lash, rod, or the like, especially by way of punishment or chastisement; 
whistle: to make a clear musical sound, a series of such sounds, or a high-pitched, warbling sound by the forcible expulsion of the breath through a small opening formed by contracting the lips, or through the teeth, with the aid of the tongue.
white: of the color of pure snow, of the margins of this page, etc.; reflecting nearly all the rays of sunlight or a similar light.
who: what person or persons?: 
why: for what? for what reason, cause, or purpose?: 
wide: having considerable or great extent from side to side; broad: 
will: am (is, are, etc.) about or going to: 
wind: air in natural motion, as that moving horizontally at any velocity along the earth&#39;s surface: 
window: an opening in the wall of a building, the side of a vehicle, etc., for the admission of air or light, or both, commonly fitted with a frame in which are set movable sashes containing panes of glass.
wine: the fermented juice of grapes, made in many varieties, such as red, white, sweet, dry, still, and sparkling, for use as a beverage, in cooking, in religious rites, etc., and usually having an alcoholic content of 14 percent or less.
wing: either of the two forelimbs of most birds and of bats, corresponding to the human arms, that are specialized for flight.
winter: the cold season between autumn and spring in northern latitudes (in the Northern Hemisphere from the 
wire: a slender, stringlike piece or filament of relatively rigid or flexible metal, usually circular in section, manufactured in a great variety of diameters and metals depending on its application.
wise: having the power of discerning and judging properly as to what is true or right; possessing discernment, judgment, or discretion.
with: accompanied by; accompanying: 
woman: an adult female person.
wood: the hard, fibrous substance composing most of the stem and branches of a tree or shrub, and lying beneath the bark; the xylem.
wool: the fine, soft, curly hair that forms the fleece of sheep and certain other animals, characterized by minute, overlapping surface scales that give it its felting property.
word: a unit of language, consisting of one or more spoken sounds or their written representation, that functions as a principal carrier of meaning. Words are composed of one or more morphemes and are either the smallest units susceptible of independent use or consist of two or thre
work: exertion or effort directed to produce or accomplish something; 
worm: 
wound: an injury, usually involving division of tissue or rupture of the integument or mucous membrane, due to external violence or some mechanical agency rather than disease.
writing: the act of a person or thing that 
wrong: not in accordance with what is morally right or good: 
year: a period of 365 or 366 days, in the Gregorian calendar, divided into 12 calendar months, now reckoned as beginning Jan. 1 and ending Dec. 31 
yellow: a color like that of egg yolk, ripe lemons, etc.; the primary color between green and orange in the visible spectrum, an effect of light with a wavelength between 570 and 590 nanometers.
yes: (used to express affirmation or assent or to mark the addition of something emphasizing and amplifying a previous statement): 
yesterday: on the day preceding this day.
you: the pronoun of the second person singular or plural, used of the person or persons being addressed, in the nominative or objective case: 
young: being in the first or early stage of life or growth; youthful; not old: 
Bernhard: False
Breytenbach: False
Android: an automaton in the form of a human being.